"country","region","region_code","start_date","end_date","days","year","week","population","total_deaths","covid_deaths","expected_deaths","excess_deaths","non_covid_deaths","covid_deaths_per_100k","excess_deaths_per_100k","excess_deaths_pct_change"
"Mexico","Mexico","0",2019-12-29,2020-01-04,7,2020,"1",119530753,16008,0,16146,-138,16008,0,-0.115451460428765,-0.00854700854700852
"Mexico","Mexico","0",2020-01-05,2020-01-11,7,2020,"2",119530753,16452,0,15886,566,16452,0,0.47351830871508,0.0356288555961224
"Mexico","Mexico","0",2020-01-12,2020-01-18,7,2020,"3",119530753,16175,0,15965,210,16175,0,0.175687005000295,0.0131537738803633
"Mexico","Mexico","0",2020-01-19,2020-01-25,7,2020,"4",119530753,15404,0,15821,-417,15404,0,-0.348864195643443,-0.026357373111687
"Mexico","Mexico","0",2020-01-26,2020-02-01,7,2020,"5",119530753,15246,0,15533,-287,15246,0,-0.240105573500403,-0.0184767913474538
"Mexico","Mexico","0",2020-02-02,2020-02-08,7,2020,"6",119530753,15393,0,15535,-142,15393,0,-0.118797879571628,-0.00914065014483423
"Mexico","Mexico","0",2020-02-09,2020-02-15,7,2020,"7",119530753,14988,0,15426,-438,14988,0,-0.366432896143472,-0.0283936211590821
"Mexico","Mexico","0",2020-02-16,2020-02-22,7,2020,"8",119530753,14367,0,14810,-443,14367,0,-0.37061592007205,-0.0299122214719784
"Mexico","Mexico","0",2020-02-23,2020-02-29,7,2020,"9",119530753,13875,0,14736,-861,13875,0,-0.720316720501209,-0.058428338762215
"Mexico","Mexico","0",2020-03-01,2020-03-07,7,2020,"10",119530753,13946,0,14210,-264,13946,0,-0.220863663428942,-0.0185784658691063
"Mexico","Mexico","0",2020-03-08,2020-03-14,7,2020,"11",119530753,13785,0,14226,-441,13785,0,-0.368942710500619,-0.0309995782370308
"Mexico","Mexico","0",2020-03-15,2020-03-21,7,2020,"12",119530753,13128,2,13708,-580,13126,0.00167320957143138,-0.4852307757151,-0.042311059235483
"Mexico","Mexico","0",2020-03-22,2020-03-28,7,2020,"13",119530753,13497,14,13505,-8,13483,0.0117124670000197,-0.00669283828572551,-0.000592373195112961
"Mexico","Mexico","0",2020-03-29,2020-04-04,7,2020,"14",119530753,13410,63,13522,-112,13347,0.0527061015000884,-0.0936997360001572,-0.00828279840260315
"Mexico","Mexico","0",2020-04-05,2020-04-11,7,2020,"15",119530753,13764,194,13169,595,13570,0.162301328428844,0.497779847500835,0.0451818665046702
"Mexico","Mexico","0",2020-04-12,2020-04-18,7,2020,"16",119530753,14510,377,13025,1485,14133,0.315400004214815,1.2423581067878,0.114011516314779
"Mexico","Mexico","0",2020-04-19,2020-04-25,7,2020,"17",119530753,16615,655,13222,3393,15960,0.547976134643777,2.83860003793333,0.256617758281652
"Mexico","Mexico","0",2020-04-26,2020-05-02,7,2020,"18",119530753,18300,756,13153,5147,17544,0.632473218001061,4.30600483207865,0.391317570136091
"Mexico","Mexico","0",2020-05-03,2020-05-09,7,2020,"19",119530753,20303,1292,12741,7562,19011,1.08089338314467,6.32640538958204,0.593516992386783
"Mexico","Mexico","0",2020-05-10,2020-05-16,7,2020,"20",119530753,21789,1692,13289,8500,20097,1.41553529743095,7.11114067858336,0.639626758973587
"Mexico","Mexico","0",2020-05-17,2020-05-23,7,2020,"21",119530753,22862,2134,13146,9716,20728,1.78531461271728,8.12845209801364,0.739084132055378
"Mexico","Mexico","0",2020-05-24,2020-05-30,7,2020,"22",119530753,22827,2600,13263,9564,20227,2.17517244286079,8.00128817058485,0.721103822664556
"Mexico","Mexico","0",2020-05-31,2020-06-06,7,2020,"23",119530753,23445,3732,12956,10489,19713,3.12220906029095,8.77514759737187,0.809586292065452
"Mexico","Mexico","0",2020-06-07,2020-06-13,7,2020,"24",119530753,24301,3361,12583,11718,20940,2.81182868479043,9.80333487901645,0.931256457124692
"Mexico","Mexico","0",2020-06-14,2020-06-20,7,2020,"25",119530753,24292,3909,13139,11153,20383,3.27028810736263,9.33065317508708,0.848846944211888
"Mexico","Mexico","0",2020-06-21,2020-06-27,7,2020,"26",119530753,23958,5600,12766,11192,18358,4.68498680000786,9.36328076173,0.876703744320852
"Mexico","Mexico","0",2020-06-28,2020-07-04,7,2020,"27",119530753,24776,3985,12643,12133,20791,3.33387007107702,10.1505258650885,0.95966147275172
"Mexico","Mexico","0",2020-07-05,2020-07-11,7,2020,"28",119530753,25926,4364,12950,12976,21562,3.65094328486327,10.8557836994468,1.00200772200772
"Mexico","Mexico","0",2020-07-12,2020-07-18,7,2020,"29",119530753,27424,4158,13032,14392,23266,3.47860269900584,12.0404160760202,1.10435850214856
"Mexico","Mexico","0",2020-07-19,2020-07-25,7,2020,"30",119530753,26213,4486,13319,12894,21727,3.75300906872058,10.7871821070181,0.968090697499812
"Mexico","Mexico","0",2020-07-26,2020-08-01,7,2020,"31",119530753,24285,4098,13075,11210,20187,3.4284064118629,9.37833964787288,0.85736137667304
"Mexico","Mexico","0",2020-08-02,2020-08-08,7,2020,"32",119530753,23438,4534,12617,10821,18904,3.79316609843494,9.05290038622947,0.857652373781406
"Mexico","Mexico","0",2020-08-09,2020-08-15,7,2020,"33",119530753,22178,4537,12644,9534,17641,3.79567591279208,7.97619002701338,0.75403353369187
"Mexico","Mexico","0",2020-08-16,2020-08-22,7,2020,"34",119530753,21291,3711,12502,8789,17580,3.10464035979092,7.35291946165519,0.703007518796992
"Mexico","Mexico","0",2020-08-23,2020-08-29,7,2020,"35",119530753,20426,3565,12640,7786,16861,2.98249606107643,6.51380486158236,0.615981012658228
"Mexico","Mexico","0",2020-08-30,2020-09-05,7,2020,"36",119530753,19825,3507,12814,7011,16318,2.93397298350492,5.8654361526527,0.547135945060091
"Mexico","Mexico","0",2020-09-06,2020-09-12,7,2020,"37",119530753,18912,3278,13076,5836,15634,2.74239048757603,4.88242552943676,0.446313857448761
"Mexico","Mexico","0",2020-09-13,2020-09-19,7,2020,"38",119530753,18104,2654,13222,4882,15450,2.22034910128944,4.084304563864,0.36923309635456
"Mexico","Mexico","0",2020-09-20,2020-09-26,7,2020,"39",119530753,18234,2985,12731,5503,15249,2.49726528536133,4.60383613579344,0.432251983347734
"Mexico","Mexico","0",2020-09-27,2020-10-03,7,2020,"40",119530753,17786,2637,12945,4841,15149,2.20612681993227,4.05000376764965,0.373966782541522
"Mexico","Mexico","0",2020-10-04,2020-10-10,7,2020,"41",119530753,17717,4762,13201,4516,12955,3.98391198957811,3.77810721229205,0.342095295810923
"Mexico","Mexico","0",2020-10-11,2020-10-17,7,2020,"42",119530753,18041,2417,13266,4775,15624,2.02207376707482,3.99478785179242,0.359942710688979
"Mexico","Mexico","0",2020-10-18,2020-10-24,7,2020,"43",119530753,18335,2684,13314,5021,15651,2.24544724486091,4.20059262907848,0.37712182664864
"Mexico","Mexico","0",2020-10-25,2020-10-31,7,2020,"44",119530753,19137,3010,13696,5441,16127,2.51818040500422,4.55196663907907,0.397269275700935
"Mexico","Mexico","0",2020-11-01,2020-11-07,7,2020,"45",119530753,19448,3055,13764,5684,16393,2.55582762036143,4.75526160200798,0.412961348445219
"Mexico","Mexico","0",2020-11-08,2020-11-14,7,2020,"46",119530753,19738,3451,13953,5785,16287,2.88712311550484,4.83975868536526,0.414606177882893
"Mexico","Mexico","0",2020-11-15,2020-11-21,7,2020,"47",119530753,19864,3114,14759,5105,16750,2.60518730271866,4.27086743107859,0.345890642997493
"Mexico","Mexico","0",2020-11-22,2020-11-28,7,2020,"48",119530753,20135,4086,14490,5645,16049,3.41836715443431,4.72263401536507,0.389579020013803
"Mexico","Mexico","0",2020-11-29,2020-12-05,7,2020,"49",119530753,19932,3997,14767,5165,15935,3.34390932850561,4.32106371822154,0.349766370962281
"Mexico","Mexico","0",2020-12-06,2020-12-12,7,2020,"50",119530753,20712,4248,15882,4830,16464,3.55389712972025,4.04080111500678,0.304117869285984
