"country","region","region_code","start_date","end_date","year","week","population","total_deaths","covid_deaths","expected_deaths","excess_deaths","non_covid_deaths","covid_deaths_per_100k","excess_deaths_per_100k","excess_deaths_pct_change"
"Mexico","Mexico","0","2019-12-29","2020-01-04",2020,"1",119530753,15998,0,16146,-148,15998,0,-0.123817508285922,-0.00916635699244395
"Mexico","Mexico","0","2020-01-05","2020-01-11",2020,"2",119530753,16443,0,15886,557,16443,0,0.465988865643639,0.0350623190230392
"Mexico","Mexico","0","2020-01-12","2020-01-18",2020,"3",119530753,16162,0,15965,197,16162,0,0.164811142785991,0.0123394926401503
"Mexico","Mexico","0","2020-01-19","2020-01-25",2020,"4",119530753,15392,0,15821,-429,15392,0,-0.358903453072031,-0.0271158586688578
"Mexico","Mexico","0","2020-01-26","2020-02-01",2020,"5",119530753,15230,0,15533,-303,15230,0,-0.253491250071854,-0.0195068563703084
"Mexico","Mexico","0","2020-02-02","2020-02-08",2020,"6",119530753,15371,0,15535,-164,15371,0,-0.137203184857373,-0.0105568072095269
"Mexico","Mexico","0","2020-02-09","2020-02-15",2020,"7",119530753,14972,0,15426,-454,14972,0,-0.379818572714923,-0.0294308310644367
"Mexico","Mexico","0","2020-02-16","2020-02-22",2020,"8",119530753,14354,0,14810,-456,14354,0,-0.381491782286354,-0.0307900067521945
"Mexico","Mexico","0","2020-02-23","2020-02-29",2020,"9",119530753,13865,0,14736,-871,13865,0,-0.728682768358365,-0.0591069489685125
"Mexico","Mexico","0","2020-03-01","2020-03-07",2020,"10",119530753,13918,0,14210,-292,13918,0,-0.244288597428981,-0.02054890921886
"Mexico","Mexico","0","2020-03-08","2020-03-14",2020,"11",119530753,13762,0,14226,-464,13762,0,-0.38818462057208,-0.0326163362856741
"Mexico","Mexico","0","2020-03-15","2020-03-21",2020,"12",119530753,13105,2,13708,-603,13103,0.00167320957143138,-0.504472685786561,-0.0439889115844763
"Mexico","Mexico","0","2020-03-22","2020-03-28",2020,"13",119530753,13474,14,13505,-31,13460,0.0117124670000197,-0.0259347483571864,-0.00229544613106258
"Mexico","Mexico","0","2020-03-29","2020-04-04",2020,"14",119530753,13389,63,13522,-133,13326,0.0527061015000884,-0.111268436500187,-0.00983582310309128
"Mexico","Mexico","0","2020-04-05","2020-04-11",2020,"15",119530753,13742,194,13169,573,13548,0.162301328428844,0.47937454221509,0.0435112764826486
"Mexico","Mexico","0","2020-04-12","2020-04-18",2020,"16",119530753,14483,377,13025,1458,14106,0.315400004214815,1.21976977757348,0.11193857965451
"Mexico","Mexico","0","2020-04-19","2020-04-25",2020,"17",119530753,16588,655,13222,3366,15933,0.547976134643777,2.81601170871901,0.254575707154742
"Mexico","Mexico","0","2020-04-26","2020-05-02",2020,"18",119530753,18269,756,13153,5116,17513,0.632473218001061,4.28007008372147,0.388960693377937
"Mexico","Mexico","0","2020-05-03","2020-05-09",2020,"19",119530753,20274,1292,12741,7533,18982,1.08089338314467,6.30214385079629,0.591240875912409
"Mexico","Mexico","0","2020-05-10","2020-05-16",2020,"20",119530753,21750,1692,13289,8461,20058,1.41553529743095,7.07851309194045,0.636692000903002
"Mexico","Mexico","0","2020-05-17","2020-05-23",2020,"21",119530753,22805,2134,13146,9659,20671,1.78531461271728,8.08076562522784,0.734748212383995
"Mexico","Mexico","0","2020-05-24","2020-05-30",2020,"22",119530753,22768,2600,13263,9505,20168,2.17517244286079,7.95192848822763,0.716655357008218
"Mexico","Mexico","0","2020-05-31","2020-06-06",2020,"23",119530753,23388,3732,12956,10432,19656,3.12220906029095,8.72746112458607,0.805186786045076
"Mexico","Mexico","0","2020-06-07","2020-06-13",2020,"24",119530753,24240,3361,12583,11657,20879,2.81182868479043,9.75230198708779,0.926408646586665
"Mexico","Mexico","0","2020-06-14","2020-06-20",2020,"25",119530753,24225,3909,13139,11086,20316,3.27028810736263,9.27460065444413,0.843747621584595
"Mexico","Mexico","0","2020-06-21","2020-06-27",2020,"26",119530753,23879,5600,12766,11113,18279,4.68498680000786,9.29718898365846,0.870515431615228
"Mexico","Mexico","0","2020-06-28","2020-07-04",2020,"27",119530753,24684,3985,12643,12041,20699,3.33387007107702,10.0735582248026,0.952384718816736
"Mexico","Mexico","0","2020-07-05","2020-07-11",2020,"28",119530753,25829,4364,12950,12879,21465,3.65094328486327,10.7746330352324,0.994517374517375
"Mexico","Mexico","0","2020-07-12","2020-07-18",2020,"29",119530753,27338,4158,13032,14306,23180,3.47860269900584,11.9684680644487,1.09775936157152
"Mexico","Mexico","0","2020-07-19","2020-07-25",2020,"30",119530753,26123,4486,13319,12804,21637,3.75300906872058,10.7118876763037,0.961333433440949
"Mexico","Mexico","0","2020-07-26","2020-08-01",2020,"31",119530753,24182,4098,13075,11107,20084,3.4284064118629,9.29216935494416,0.849483747609943
"Mexico","Mexico","0","2020-08-02","2020-08-08",2020,"32",119530753,23340,4534,12617,10723,18806,3.79316609843494,8.97091311722934,0.849885075691527
"Mexico","Mexico","0","2020-08-09","2020-08-15",2020,"33",119530753,22077,4537,12644,9433,17540,3.79567591279208,7.8916929436561,0.746045555204049
"Mexico","Mexico","0","2020-08-16","2020-08-22",2020,"34",119530753,21226,3711,12502,8724,17515,3.10464035979092,7.29854015058368,0.697808350663894
"Mexico","Mexico","0","2020-08-23","2020-08-29",2020,"35",119530753,20339,3565,12640,7699,16774,2.98249606107643,6.44102024522509,0.609098101265823
"Mexico","Mexico","0","2020-08-30","2020-09-05",2020,"36",119530753,19754,3507,12814,6940,16247,2.93397298350492,5.80603721286688,0.541595130326206
"Mexico","Mexico","0","2020-09-06","2020-09-12",2020,"37",119530753,18846,3278,13076,5770,15568,2.74239048757603,4.82720961357953,0.441266442337106
"Mexico","Mexico","0","2020-09-13","2020-09-19",2020,"38",119530753,18034,2654,13222,4812,15380,2.22034910128944,4.0257422288639,0.363938889729239
"Mexico","Mexico","0","2020-09-20","2020-09-26",2020,"39",119530753,18155,2985,12731,5424,15170,2.49726528536133,4.5377443577219,0.426046657764512
"Mexico","Mexico","0","2020-09-27","2020-10-03",2020,"40",119530753,17720,2637,12945,4775,15083,2.20612681993227,3.99478785179242,0.368868288914639
"Mexico","Mexico","0","2020-10-04","2020-10-10",2020,"41",119530753,17630,4762,13201,4429,12868,3.98391198957811,3.70532259593479,0.335504885993485
"Mexico","Mexico","0","2020-10-11","2020-10-17",2020,"42",119530753,17940,2417,13266,4674,15523,2.02207376707482,3.91029076843513,0.352329262777024
"Mexico","Mexico","0","2020-10-18","2020-10-24",2020,"43",119530753,18216,2684,13314,4902,15532,2.24544724486091,4.10103665957831,0.36818386660658
"Mexico","Mexico","0","2020-10-25","2020-10-31",2020,"44",119530753,18913,3010,13696,5217,15903,2.51818040500422,4.36456716707875,0.380914135514019
"Mexico","Mexico","0","2020-11-01","2020-11-07",2020,"45",119530753,19140,3055,13764,5376,16085,2.55582762036143,4.49758732800755,0.390584132519616
"Mexico","Mexico","0","2020-11-08","2020-11-14",2020,"46",119530753,19318,3451,13953,5365,15867,2.88712311550484,4.48838467536467,0.384505124346019
"Mexico","Mexico","0","2020-11-15","2020-11-21",2020,"47",119530753,19338,3114,14759,4579,16224,2.60518730271866,3.83081331379214,0.310251372044176
