"country","region","region_code","start_date","end_date","year","week","population","total_deaths","covid_deaths","expected_deaths","excess_deaths","non_covid_deaths","covid_deaths_per_100k","excess_deaths_per_100k","excess_deaths_pct_change"
"Mexico","Mexico","0","2019-12-29","2020-01-04",2020,"1",104714530,15928,0,16121,-193,15928,0,-0.184310620503191,-0.0119719620370945
"Mexico","Mexico","0","2020-01-05","2020-01-11",2020,"2",104714530,16378,0,15855,523,16378,0,0.499453132244398,0.0329864396089561
"Mexico","Mexico","0","2020-01-12","2020-01-18",2020,"3",104714530,16083,0,15940,143,16083,0,0.136561755087856,0.00897114178168135
"Mexico","Mexico","0","2020-01-19","2020-01-25",2020,"4",104714530,15313,0,15795,-482,15313,0,-0.460299062603824,-0.0305159860715416
"Mexico","Mexico","0","2020-01-26","2020-02-01",2020,"5",104714530,15142,0,15505,-363,15142,0,-0.346656762915328,-0.0234118026443083
"Mexico","Mexico","0","2020-02-02","2020-02-08",2020,"6",104714530,15294,0,15518,-224,15294,0,-0.213914917060698,-0.014434849851785
"Mexico","Mexico","0","2020-02-09","2020-02-15",2020,"7",104714530,14882,0,15409,-527,14882,0,-0.503273041477625,-0.0342007917450841
"Mexico","Mexico","0","2020-02-16","2020-02-22",2020,"8",104714530,14251,0,14806,-555,14251,0,-0.530012406110212,-0.0374848034580575
"Mexico","Mexico","0","2020-02-23","2020-02-29",2020,"9",104714530,13773,0,14729,-956,13773,0,-0.912958306741194,-0.0649059678185891
"Mexico","Mexico","0","2020-03-01","2020-03-07",2020,"10",104714530,13754,0,14206,-452,13754,0,-0.431649743354623,-0.0318175418837111
"Mexico","Mexico","0","2020-03-08","2020-03-14",2020,"11",104714530,13584,0,14219,-635,13584,0,-0.606410590774747,-0.04465855545397
"Mexico","Mexico","0","2020-03-15","2020-03-21",2020,"12",104714530,12953,2,13700,-747,12951,0.00190995461661338,-0.713368049305096,-0.0545255474452555
"Mexico","Mexico","0","2020-03-22","2020-03-28",2020,"13",104714530,13297,14,13501,-204,13283,0.0133696823162936,-0.194815370894564,-0.0151099918524554
"Mexico","Mexico","0","2020-03-29","2020-04-04",2020,"14",104714530,13200,63,13494,-294,13137,0.0601635704233214,-0.280763328642166,-0.0217874610938195
"Mexico","Mexico","0","2020-04-05","2020-04-11",2020,"15",104714530,13546,194,13157,389,13352,0.185265597811498,0.371486172931302,0.0295660104887132
"Mexico","Mexico","0","2020-04-12","2020-04-18",2020,"16",104714530,14264,377,13008,1256,13887,0.360026445231622,1.1994514992332,0.0965559655596555
"Mexico","Mexico","0","2020-04-19","2020-04-25",2020,"17",104714530,16343,655,13203,3140,15688,0.625510136940881,2.998628748083,0.237824736802242
"Mexico","Mexico","0","2020-04-26","2020-05-02",2020,"18",104714530,18053,756,13133,4920,17297,0.721962845079857,4.69848835686891,0.374628797685221
"Mexico","Mexico","0","2020-05-03","2020-05-09",2020,"19",104714530,20027,1292,12727,7300,18735,1.23383068233224,6.97133435063883,0.573583719651135
"Mexico","Mexico","0","2020-05-10","2020-05-16",2020,"20",104714530,21485,1692,13268,8217,19793,1.61582160565492,7.84704854235606,0.619309617123907
"Mexico","Mexico","0","2020-05-17","2020-05-23",2020,"21",104714530,22466,2134,13127,9339,20332,2.03792157592647,8.91853308227616,0.711434448084102
"Mexico","Mexico","0","2020-05-24","2020-05-30",2020,"22",104714530,22388,2600,13228,9160,19788,2.48294100159739,8.74759214408927,0.692470517084971
"Mexico","Mexico","0","2020-05-31","2020-06-06",2020,"23",104714530,22921,3732,12925,9996,19189,3.56397531460056,9.54595317383366,0.773384912959381
"Mexico","Mexico","0","2020-06-07","2020-06-13",2020,"24",104714530,23508,3361,12560,10948,20147,3.20967873321878,10.4550915713416,0.871656050955414
"Mexico","Mexico","0","2020-06-14","2020-06-20",2020,"25",104714530,23464,3909,13113,10351,19555,3.73300629817085,9.88497011828253,0.78936932814764
"Mexico","Mexico","0","2020-06-21","2020-06-27",2020,"26",104714530,23228,5600,12724,10504,17628,5.34787292651746,10.0310816464535,0.825526563973593
"Mexico","Mexico","0","2020-06-28","2020-07-04",2020,"27",104714530,23883,3985,12609,11274,19898,3.80558457360215,10.7664141738496,0.894123245300976
"Mexico","Mexico","0","2020-07-05","2020-07-11",2020,"28",104714530,24900,4364,12901,11999,20536,4.16752097345039,11.458772722372,0.93008293930703
"Mexico","Mexico","0","2020-07-12","2020-07-18",2020,"29",104714530,26369,4158,12978,13391,22211,3.97079564793921,12.7881011355349,1.03182308522114
"Mexico","Mexico","0","2020-07-19","2020-07-25",2020,"30",104714530,25058,4486,13260,11798,20572,4.28402820506381,11.2668222834023,0.88974358974359
"Mexico","Mexico","0","2020-07-26","2020-08-01",2020,"31",104714530,23120,4098,13023,10097,19022,3.91349700944081,9.64240588197264,0.775320586654381
"Mexico","Mexico","0","2020-08-02","2020-08-08",2020,"32",104714530,22290,4534,12561,9729,17756,4.32986711586253,9.29097423251577,0.774540243611177
"Mexico","Mexico","0","2020-08-09","2020-08-15",2020,"33",104714530,20942,4537,12604,8338,16405,4.33273204778745,7.96260079666117,0.661536020311012
"Mexico","Mexico","0","2020-08-16","2020-08-22",2020,"34",104714530,20087,3711,12431,7656,16376,3.54392079112612,7.31130627239601,0.615879655699461
"Mexico","Mexico","0","2020-08-23","2020-08-29",2020,"35",104714530,19061,3565,12557,6504,15496,3.40449410411335,6.2111724132267,0.517958111013777
"Mexico","Mexico","0","2020-08-30","2020-09-05",2020,"36",104714530,18057,3735,12770,5287,14322,3.56684024652548,5.04896502901746,0.414017227877839
"Mexico","Mexico","0","2020-09-06","2020-09-12",2020,"37",104714530,16927,3050,13040,3887,13877,2.9126807903354,3.7119967973881,0.29808282208589
"Mexico","Mexico","0","2020-09-13","2020-09-19",2020,"38",104714530,16018,2654,13171,2847,13364,2.53450977624595,2.71882039674914,0.216156707918913
"Mexico","Mexico","0","2020-09-20","2020-09-26",2020,"39",104714530,15853,2985,12602,3251,12868,2.85060726529547,3.10463122930505,0.25797492461514
