"country","region","region_code","start_date","end_date","days","year","week","population","total_deaths","covid_deaths","expected_deaths","excess_deaths","non_covid_deaths","covid_deaths_per_100k","excess_deaths_per_100k","excess_deaths_pct_change"
"South Africa","South Africa","0",2020-01-01,2020-01-07,7,2020,"1",58775022,9931,0,9029,902,9931,0,1.5346655250933,0.0999003211872853
"South Africa","South Africa","0",2020-01-08,2020-01-14,7,2020,"2",58775022,8726,0,8938,-212,8726,0,-0.360697440487559,-0.0237189527858581
"South Africa","South Africa","0",2020-01-15,2020-01-21,7,2020,"3",58775022,8300,0,8420,-120,8300,0,-0.204168362540128,-0.0142517814726841
"South Africa","South Africa","0",2020-01-22,2020-01-28,7,2020,"4",58775022,8328,0,8088,240,8328,0,0.408336725080256,0.029673590504451
"South Africa","South Africa","0",2020-01-29,2020-02-04,7,2020,"5",58775022,9193,0,8577,616,9193,0,1.04806426103932,0.0718199836772764
"South Africa","South Africa","0",2020-02-05,2020-02-11,7,2020,"6",58775022,8739,0,8564,175,8739,0,0.297745528704353,0.0204343764595982
"South Africa","South Africa","0",2020-02-12,2020-02-18,7,2020,"7",58775022,8600,0,8189,411,8600,0,0.699276641699939,0.0501892783001587
"South Africa","South Africa","0",2020-02-19,2020-02-25,7,2020,"8",58775022,8325,0,8262,63,8325,0,0.107188390333567,0.00762527233115473
"South Africa","South Africa","0",2020-02-26,2020-03-03,7,2020,"9",58775022,8735,0,8909,-174,8735,0,-0.296044125683186,-0.0195308115388932
"South Africa","South Africa","0",2020-03-04,2020-03-10,7,2020,"10",58775022,9082,0,8613,469,9082,0,0.797958016927667,0.054452571693951
"South Africa","South Africa","0",2020-03-11,2020-03-17,7,2020,"11",58775022,8573,0,8365,208,8573,0,0.353891828402889,0.0248655110579796
"South Africa","South Africa","0",2020-03-18,2020-03-24,7,2020,"12",58775022,8421,0,8396,25,8421,0,0.0425350755291933,0.00297760838494532
"South Africa","South Africa","0",2020-03-25,2020-03-31,7,2020,"13",58775022,8272,5,8811,-539,8267,0.00850701510583867,-0.917056228409408,-0.0611735330836455
"South Africa","South Africa","0",2020-04-01,2020-04-07,7,2020,"14",58775022,8112,8,8823,-711,8104,0.0136112241693419,-1.20969754805026,-0.0805848350901054
"South Africa","South Africa","0",2020-04-08,2020-04-14,7,2020,"15",58775022,8181,14,8660,-479,8167,0.0238196422963483,-0.814972047139344,-0.0553117782909931
"South Africa","South Africa","0",2020-04-15,2020-04-21,7,2020,"16",58775022,7994,31,8680,-686,7963,0.0527434936561997,-1.16716247252107,-0.0790322580645161
"South Africa","South Africa","0",2020-04-22,2020-04-28,7,2020,"17",58775022,7632,35,9086,-1454,7597,0.0595491057408707,-2.47383999277788,-0.160026414263702
"South Africa","South Africa","0",2020-04-29,2020-05-05,7,2020,"18",58775022,8301,55,9447,-1146,8246,0.0935771661642253,-1.94980786225822,-0.121308351857733
"South Africa","South Africa","0",2020-05-06,2020-05-12,7,2020,"19",58775022,8469,58,9501,-1032,8411,0.0986813752277285,-1.7558479178451,-0.108620145247869
"South Africa","South Africa","0",2020-05-13,2020-05-19,7,2020,"20",58775022,8616,106,9358,-742,8510,0.18034872024378,-1.26244104170646,-0.0792904466766403
"South Africa","South Africa","0",2020-05-20,2020-05-26,7,2020,"21",58775022,8784,212,9578,-794,8572,0.360697440487559,-1.35091399880718,-0.0828983086239299
"South Africa","South Africa","0",2020-05-27,2020-06-02,7,2020,"22",58775022,9884,231,10195,-311,9653,0.393024097889746,-0.529136339583165,-0.030505149583129
"South Africa","South Africa","0",2020-06-03,2020-06-09,7,2020,"23",58775022,10165,407,10880,-715,9758,0.692471029615268,-1.21650316013493,-0.0657169117647058
"South Africa","South Africa","0",2020-06-10,2020-06-16,7,2020,"24",58775022,11066,463,11130,-64,10603,0.787749598800661,-0.108889793354735,-0.00575022461814911
"South Africa","South Africa","0",2020-06-17,2020-06-23,7,2020,"25",58775022,12044,477,11129,915,11567,0.811569241097009,1.55678376436848,0.0822176296163177
"South Africa","South Africa","0",2020-06-24,2020-06-30,7,2020,"26",58775022,12666,555,10760,1906,12111,0.944278676748092,3.2428741583457,0.177137546468402
"South Africa","South Africa","0",2020-07-01,2020-07-07,7,2020,"27",58775022,13976,845,10815,3161,13131,1.43768555288673,5.37813494991121,0.292279241793805
"South Africa","South Africa","0",2020-07-08,2020-07-14,7,2020,"28",58775022,15141,844,9935,5206,14297,1.43598414986557,8.85750412819922,0.524006039255158
"South Africa","South Africa","0",2020-07-15,2020-07-21,7,2020,"29",58775022,16468,1022,9966,6502,15446,1.73883388763342,11.0625224436326,0.652418221954646
"South Africa","South Africa","0",2020-07-22,2020-07-28,7,2020,"30",58775022,15468,1889,9733,5735,13579,3.21395030698585,9.75754632639695,0.589232507962602
"South Africa","South Africa","0",2020-07-29,2020-08-04,7,2020,"31",58775022,14465,1627,9921,4544,12838,2.7681827154399,7.73117532818618,0.458018344924907
"South Africa","South Africa","0",2020-08-05,2020-08-11,7,2020,"32",58775022,12889,1867,9875,3014,11022,3.17651944052016,5.12802870579955,0.305215189873418
"South Africa","South Africa","0",2020-08-12,2020-08-18,7,2020,"33",58775022,11817,1513,9534,2283,10304,2.57422277102678,3.88430309732594,0.239458779106356
"South Africa","South Africa","0",2020-08-19,2020-08-25,7,2020,"34",58775022,11752,1044,9278,2474,10708,1.77626475409911,4.20927107436897,0.266652295753395
"South Africa","South Africa","0",2020-08-26,2020-09-01,7,2020,"35",58775022,10615,955,9628,987,9660,1.62483988521519,1.67928478189255,0.102513502285002
"South Africa","South Africa","0",2020-09-02,2020-09-08,7,2020,"36",58775022,10755,823,9641,1114,9932,1.40025468642104,1.89536296558086,0.115548179649414
"South Africa","South Africa","0",2020-09-09,2020-09-15,7,2020,"37",58775022,9547,555,9369,178,8992,0.944278676748092,0.302849737767857,0.0189988259152525
"South Africa","South Africa","0",2020-09-16,2020-09-22,7,2020,"38",58775022,9513,477,9213,300,9036,0.811569241097009,0.51042090635032,0.0325626831650927
"South Africa","South Africa","0",2020-09-23,2020-09-29,7,2020,"39",58775022,9643,549,9297,346,9094,0.934070258621086,0.588685445324036,0.037216306335377
"South Africa","South Africa","0",2020-09-30,2020-10-06,7,2020,"40",58775022,9699,436,9510,189,9263,0.741811717229132,0.321565171000702,0.0198738170347004
"South Africa","South Africa","0",2020-10-07,2020-10-13,7,2020,"41",58775022,9974,925,8860,1114,9049,1.57379779458015,1.89536296558086,0.125733634311513
"South Africa","South Africa","0",2020-10-14,2020-10-20,7,2020,"42",58775022,10174,628,8833,1341,9546,1.06848109729334,2.28158145138593,0.151817049699989
"South Africa","South Africa","0",2020-10-21,2020-10-27,7,2020,"43",58775022,9750,397,8994,756,9353,0.67545699940359,1.28626068400281,0.0840560373582389
"South Africa","South Africa","0",2020-10-28,2020-11-03,7,2020,"44",58775022,9533,486,9057,476,9047,0.826881868287518,0.809867838075841,0.0525560340068456
"South Africa","South Africa","0",2020-11-04,2020-11-10,7,2020,"45",58775022,10276,412,8740,1536,9864,0.700978044721106,2.61335504051364,0.175743707093821
"South Africa","South Africa","0",2020-11-11,2020-11-17,7,2020,"46",58775022,9990,481,8786,1204,9509,0.81837485318168,2.04848923748595,0.137036193944912
"South Africa","South Africa","0",2020-11-18,2020-11-24,7,2020,"47",58775022,10113,651,8510,1603,9462,1.10761336678019,2.72734904293188,0.188366627497062
"South Africa","South Africa","0",2020-11-25,2020-12-01,7,2020,"48",58775022,10456,561,9409,1047,9895,0.954487094875098,1.78136896316262,0.111276437453502
"South Africa","South Africa","0",2020-12-02,2020-12-08,7,2020,"49",58775022,11469,788,8941,2528,10681,1.34070558068017,4.30114683751203,0.282742422547813
"South Africa","South Africa","0",2020-12-09,2020-12-15,7,2020,"50",58775022,12420,1229,9041,3379,11191,2.09102431301514,5.74904080852577,0.373741842716514
"South Africa","South Africa","0",2020-12-16,2020-12-22,7,2020,"51",58775022,14427,1585,9475,4952,12842,2.69672378855086,8.42534776082262,0.522638522427441
"South Africa","South Africa","0",2020-12-23,2020-12-29,7,2020,"52",58775022,17567,2322,9692,7875,15245,3.95065781515148,13.3985487916959,0.812525794469666
"South Africa","South Africa","0",2020-12-30,2021-01-05,7,2021,"1",58775022,20063,2956,8855,11208,17107,5.02934733057182,19.069325061248,1.26572557876906
